                        R    2048     1024
   NO      ./textures/greystone.xpm
   SO   ./textures/bluestone.xpm
WE ./textures/redbrick.xpm

xerctvfgybhujiko

   EA         ./textures/eagle.xpm
S ./textures/barrel.xpm
F    100 , 101 ,  255
C 165   ,  219    , 250


1111111111111111111111111111111111111111111111111111111111111111111111111111111111111111111111111111111111111
1000000001000200000110000000000001100000000011000000000000000000000001100000000000011000000000110000000000001
1000000001010000001110000002000001101100000111000000200000110110000011100000020000011011000001110000002000001
1000000001001000000000000000000000000100000000000000000000110010000000000000000000000001000000000000000000001
1111111101110000011100000000000011111111110110000011100000000000011111111110110000011100000000000011111111111
1000000000000000011101111011111111000000000110000011101111011111111000000000110000011101111011111111111111111
1111011111111101110000001000111110111111111011100000010001111101111111110111000000100011111011111111111111111
1111011111111101110101001000111110111111111011101010010001111101111111110111010100100011111011111111101110101
1100000011010101110000001000111000000110101011100000010001110000001101010111000000100011100000011010101110201
1000200000000000110000001000110002000000000001100000010001100020000000000011000000100011000200200022000110001
1000000000000000110101001000110000000000000001101010010001100000000000000011010100100011000000000000000110101
1100000111010101111101111000111111110000011101010111110111100011111111000001110101011111011110001110111100001
1100000011010101110000001000111000000110101011100000010001110000001101010111000000100011100000011010101110001
1100000011010101110000001000111000000110101011100000010001110000001101010111000000100011100000011010101110001
1100000011010101110000001000111000000110101011100000010001110000001101010111000000100011100000011010101110001
1100000011010101110000001000111000000110101011100000010001110000001101010111000000100011100000011010101110001
1100000011010101110000001000111000000110101011100000010001110000001101010111000000100011100000011010101110001
1100000011010101110000001000111000000110101011100000010001110000001101010111000000100011100000011010101110001
1100000011010101110000001000111000000110101011100000010001110000001101010111000000100011100000011010101110001
1100000011010101110000001000111000000110101011100000010001110000001101010111000000100011100000011010101110001
1100000011010101110000001000111000000110101011100000010001110000001101010111000000100011100000011010101110001
1100000011010101110000001000111000000110101011100000010001110000001101010111000000100011100000011010101110001
1100000011010101110000001000111000000110101011100000010001110000001101010111000000100011100000011010001100011
1111011111111101110101001000111110111111111011101010010001111101111111110111010100100011111011111111101110101
1111011111111101110101001000111110111111111011101010010001111101111111110111010100100011111011111111101110101
1111011111111101110101001000111110111111111011101010010001111101111111110111010100100011111011111111101110101
1111011111111101110101001000111110111111111011101010010001111101111111110111010100100011111011111111101110101
1111011111111101110101001000111110111111111011101010010001111101111111110111010100100011111011111111101110101
1111011111111101110101001000111110111111111011101010010001111101111111110111010100100011111011111111101110101
1111011111111101110101001000111110111111111011101010010001111101111111110111010100100011111011111111101110101
1111011111111101110101001000111110111111111011101010010001111101111111110111010100100011111011111111101110101
1111011111111101110101001000111110111111111011101010010001111101111111110111010100100011111011111111101110101
1000200000000000110000001000110002000000000001100000010001100020000000000011000000100011000200000000000110001
100020000000000011000000100011000200000N000001100000010001100020000000000011000000100011000200000000000110001
1000200000000000110000001000110002000000000001100000010001100020000000000011000000100011000200000000000110001
1000200000000000110000001000110002000000000001100000010001100020000000000011000000100011000200000000000110001
1000200000000000110000001000110002000000000001100000010001100020000000000011000000100011000200000000000110001
1000200000000000110000001000110002000000000001100000010001100020000000000011000000100011000200000000000110001
1000200000000000110000001000110002000000000001100000010001100020000000000011000000100011000200000000000110001
1000200000000000110000001000110002000000000001100000010001100020000000000011000000100011000200000000000110001
1000200000000000000000000000000020000000000000000000000000000200000000000000000000000000002000000000001100011
111111111111111111111111111111111111111111111111111111111111111111111111111111111111111111111111111111111111
